NO ./textures/Paredes/north_wall.xpm
SO ./textures/Paredes/south_wall.xpm
EA ./textures/Paredes/east_wall.xpm
WE ./textures/Paredes/west_wall.xpm

F 120,60,30
C 180,120,255


11111111111111111111111111
 11111111111  111111111111
  100000001    1000000001
  10000001      10000001
   100001        100001
    1001          1001 
    100111111111111001
    100000000000000001
    100000000N00000001
    100000000000000001
    100111111111111001
    1001          1001
   100001        100001
  10000001      10000001
 1000000001    1000000001
111111111111  111111111111
11111111111111111111111111