NO ./textures/Paredes/north_wall.xpm
SO ./textures/Paredes/south_wall.xpm
EA ./textures/Paredes/east_wall.xpm
WE ./textures/Paredes/west_wall.xpm

F 120,60,30
C 180,120,255

111111111111111111111111111
100000000000000000000000N01
101111111011111111111110001
100000001010000000000010001
101111101011011111011010001
100000001000010001010000001
100111111111010001011111111
100100000001010000000000001
100101111101011111111111101
100101000001000000000000001
100101011111111011111011101
100000010000000000001000001
101111111011111111101011101
100000000010000000001000001
100111111110111111111111101
100100000010100000000000001
111111111111111111111111111