111111
100001
100001
101001
100001
100W01
111111